20
20
1 4 1 1 1 1 1 1 1 1 1 1 1 1 1 1 1 1 1 1
2 3 1 3 3 3 3 3 3 1 2 3 3 3 3 3 3 3 3 1
3 6 2 3 4 1 2 2 2 1 3 2 2 3 4 1 2 2 2 1
1 2 2 2 2 2 2 3 4 1 1 2 2 2 2 2 2 3 4 1
1 3 4 3 2 3 2 4 4 1 1 3 4 3 2 3 2 4 4 1
3 3 3 3 3 2 3 3 1 1 3 3 3 3 3 2 3 3 2 1
1 1 1 6 5 5 5 5 1 6 1 1 1 6 5 5 5 5 2 1
9 1 1 6 1 1 1 1 1 1 1 1 1 6 1 1 1 1 3 1
9 1 1 6 1 1 1 1 1 1 1 1 1 6 1 1 1 1 2 1
1 1 1 6 1 1 1 1 1 1 1 1 1 6 1 1 1 1 2 1
1 1 1 6 1 1 1 1 9 9 1 1 1 6 1 1 1 1 2 1
1 1 1 6 1 1 1 1 9 9 1 1 1 6 1 1 1 1 2 1
1 1 1 6 1 1 1 1 1 1 1 1 1 6 1 1 1 1 2 1
1 1 1 6 1 1 1 1 1 1 1 1 1 6 1 1 1 1 2 1
1 1 1 6 1 1 1 1 1 1 1 1 1 6 1 1 1 1 2 1
1 1 1 6 1 1 1 1 1 1 1 1 1 6 1 1 1 1 2 1
1 1 1 6 1 1 1 1 1 1 1 1 1 6 1 1 1 1 1 1
1 1 1 6 1 1 1 1 1 1 1 1 1 6 1 1 1 1 1 6
1 1 1 6 1 1 1 1 1 1 1 1 1 6 1 1 1 1 1 1
1 1 1 6 1 1 1 1 9 9 1 1 1 6 1 1 1 1 2 1
